zzzzzzzzzzzzzzzzzzzzzzzzzzzzzzzzzzzzzzzzzz
z      1 1 1 1 1          2 2 2 2 2      z
z                                        z
z                                        z
z                                        z
z                                        z
z3                                      5z
z                                        z
z3                                      5z
z                                        z
z3                                      5z
z                                        z
z3                                      5z
z                                        z
z3                                      5z
z                                        z
z                                        z
z                                        z
z                                        z
z                                        z
z                                        z
z                                        z
z                                        z
z                                        z
z                                        z
z4                                      6z
z                                        z
z4                                      6z
z                                        z
z4                                      6z
z                                        z
z4                                      6z
z                                        z
z4                                      6z
z                                        z
z                                        z
z                                        z
z                                        z
z                                        z
z      7 7 7 7 7          8 8 8 8 8      z
zzzzzzzzzzzzzzzzzzzzzzzzzzzzzzzzzzzzzzzzzz