000000000000000000000000000000
000000000000000000000000000000
000111110011111111111111100000
000100010010000000000000100000
000100010010000000000000100000
000100010010000000000000100000
000100010011110000000000100000
000100010000010000000000100000
000100011111110000000000100000
000100000000000000000000100000
000100000000000000000000100000
000100000000000000000000100000
000100111111100000000000100000
000100100000100000000000100000
000100100000100000000000100000
000111100000111111111111100000
000000000000000000000000000000
000000000000000000000000000000
000000000000000000000000000000
000000000000000000000000000000
000000000000000000000000000000
000000000000000000000000000000
000000000000000000000000000000
000000000000000000000000000000
000000000000000000000000000000
